3,3,3,3,3,3,3,3,3,3,3,3,3,3,3,3,3,3,3,3,3,3,3,3,3,3,3,3,3,3,3,3,3,3,3,3,3,3,3,3,3,3,3,3,3,3,3,3,3,2,2,2,3,3,3,3,3,3,3,3,3,3,3,3,3,3,3,3,3,3,3,3,3,3,3,3,3,3,3,3,3,3,3,3,3,3,3,3,3,3,3,3,3,3,3,3,3,3,3,3,
3,1,1,1,1,1,1,1,1,1,1,1,1,1,1,0,0,0,0,0,0,0,0,1,0,0,0,0,0,0,0,0,0,0,0,0,1,0,0,0,0,0,0,0,0,0,0,0,0,2,2,2,0,1,0,12,8,8,8,8,8,8,8,8,8,8,8,8,8,8,8,8,8,8,8,8,1,0,0,1,0,0,0,0,0,0,1,1,1,1,1,1,1,1,1,1,1,1,1,3,
3,1,1,1,1,1,1,1,1,1,1,1,9,9,9,0,1,0,1,1,1,0,0,1,0,1,1,0,0,0,0,0,0,0,0,0,1,0,0,0,0,0,0,0,0,0,0,0,0,2,2,2,0,1,0,1,1,1,1,1,1,1,1,1,1,1,1,1,1,1,8,8,8,8,8,8,1,0,0,1,1,1,1,1,1,0,1,1,1,1,1,1,1,1,1,1,1,1,1,3,
3,1,1,1,1,1,1,1,1,1,1,1,9,9,1,0,1,0,1,0,1,0,0,1,0,0,1,0,0,0,0,0,0,0,0,0,1,0,0,0,0,0,0,0,0,0,0,0,0,0,0,0,0,1,0,0,0,0,0,0,0,0,0,0,0,0,0,0,0,1,8,8,8,8,8,8,1,0,0,0,0,0,0,0,1,0,1,1,1,1,1,1,1,1,1,1,1,1,1,3,
3,1,1,1,1,1,1,1,1,1,1,1,9,1,1,0,1,1,1,0,1,0,0,1,1,1,1,1,1,1,0,0,0,0,0,0,1,0,0,0,0,0,0,1,0,0,0,1,0,0,0,0,0,1,0,0,0,1,1,1,1,1,1,1,1,1,1,1,1,1,1,1,1,1,1,1,1,1,1,1,1,1,1,0,1,0,1,1,1,1,1,1,1,1,1,1,1,1,1,3,
3,1,1,1,1,1,1,1,1,1,1,1,9,9,1,0,1,0,0,0,1,0,0,0,0,0,1,0,0,0,0,0,0,0,0,0,1,0,0,0,0,0,0,1,0,0,0,1,0,0,0,0,0,1,0,0,0,1,0,0,0,0,0,0,0,0,0,0,0,1,0,0,0,0,0,0,0,0,0,0,0,0,0,0,1,0,1,1,1,1,1,1,1,1,1,1,1,1,1,3,
3,1,1,1,1,1,1,1,1,1,1,1,9,1,1,1,1,0,1,1,1,1,1,1,1,1,1,0,0,0,0,0,0,0,0,0,1,0,0,0,0,0,0,1,0,0,0,1,1,1,0,0,0,1,0,0,0,1,0,0,0,0,0,0,0,0,0,0,0,1,0,1,1,1,1,1,1,1,1,1,1,1,1,1,1,0,1,1,1,9,9,9,9,9,9,9,1,1,1,3,
3,1,1,1,1,1,1,1,1,1,1,1,9,1,9,0,0,0,0,0,0,0,0,0,0,0,0,0,0,0,0,0,0,1,1,1,1,1,1,1,1,1,1,1,0,0,0,0,0,1,0,0,0,1,0,0,0,1,0,0,0,0,0,0,0,0,0,0,0,1,0,0,0,0,0,0,0,0,0,0,0,0,0,0,0,0,1,1,1,1,1,1,1,1,1,9,1,1,1,3,
3,1,1,1,1,1,1,1,1,1,1,1,9,1,9,1,1,1,9,1,1,1,1,9,1,9,1,1,1,1,0,0,0,0,0,0,1,0,0,0,0,0,0,1,0,0,0,0,0,1,0,0,0,1,0,0,0,1,0,0,0,1,1,1,1,1,1,1,0,1,0,1,1,1,1,1,1,1,1,1,1,1,1,1,1,9,1,1,1,1,1,1,1,1,1,9,1,1,1,3,
3,1,1,1,1,1,1,1,1,1,1,1,9,1,9,1,1,1,9,1,1,1,1,9,1,9,1,1,1,1,0,0,0,0,0,0,1,0,0,0,0,0,0,1,0,0,0,0,0,1,0,0,0,1,0,0,0,1,0,0,0,1,0,0,0,0,0,1,0,1,0,1,1,1,1,1,1,1,1,1,1,1,1,1,1,9,1,1,1,1,1,1,1,1,1,9,1,1,1,3,
3,1,1,1,1,1,1,1,1,1,1,1,9,1,9,1,1,1,9,1,1,1,1,9,1,9,1,1,1,1,0,0,0,0,0,0,1,0,0,0,0,0,0,1,0,0,0,0,0,1,0,0,0,1,0,0,0,1,0,0,0,0,0,0,0,0,0,1,0,1,0,1,1,1,1,1,1,1,1,1,1,1,1,1,10,10,10,10,10,10,10,10,10,1,1,9,1,1,1,3,
3,1,1,1,1,1,1,1,1,1,1,1,9,1,9,1,1,1,9,1,1,1,1,9,1,9,1,1,1,1,0,0,0,0,0,0,1,0,0,0,0,0,0,1,0,0,0,0,0,1,0,0,0,1,0,0,0,1,0,0,0,0,0,0,0,0,0,1,0,1,0,9,9,9,9,9,9,9,9,9,9,9,9,9,10,1,10,1,1,1,1,1,10,1,1,9,1,1,1,3,
3,1,1,1,1,1,1,1,1,1,1,1,9,1,9,1,1,1,9,1,1,1,1,9,1,9,1,1,1,1,0,0,0,0,0,0,1,0,0,0,0,0,0,1,0,0,0,0,0,1,0,0,0,1,0,0,0,1,0,0,0,0,0,0,0,0,0,1,0,1,0,9,9,1,9,1,9,1,1,1,9,1,1,1,10,1,10,1,10,10,10,10,10,9,9,9,1,1,1,3,
3,1,1,1,1,1,1,1,1,1,1,1,9,1,9,1,1,1,9,1,1,1,1,9,1,9,1,1,1,1,0,0,0,0,0,0,1,0,0,0,0,0,0,1,0,0,0,0,0,1,0,0,0,1,0,0,0,1,0,0,0,0,0,0,1,1,1,1,0,1,1,1,1,1,9,1,1,1,9,9,9,1,9,9,10,1,10,1,10,10,10,10,10,9,9,9,1,1,1,3,
3,1,1,1,1,1,1,1,1,1,1,10,10,1,10,10,1,1,9,1,1,1,10,10,10,10,10,1,1,1,0,0,0,0,0,0,1,0,0,0,1,1,1,1,1,1,0,0,0,1,0,0,0,1,0,0,0,1,0,0,0,0,0,0,1,0,0,0,0,1,0,9,9,1,9,1,9,1,9,1,1,1,1,1,1,1,10,1,10,10,10,10,10,9,9,9,1,1,1,3,
3,1,1,1,1,1,1,1,1,1,1,10,10,1,10,10,1,1,9,1,1,1,10,10,10,10,10,1,1,1,0,0,0,0,0,0,1,0,0,0,0,0,0,0,0,0,0,0,0,1,0,0,0,1,0,0,0,1,0,0,0,0,0,0,1,0,0,0,0,1,0,9,9,1,1,1,9,1,9,9,9,1,9,9,10,1,10,1,10,10,10,10,10,9,9,9,1,1,1,3,
3,1,1,1,9,9,9,9,9,9,9,10,10,1,10,10,9,9,9,9,9,9,10,10,10,10,10,9,9,9,0,0,0,0,0,0,1,0,0,0,0,0,0,0,0,0,0,0,0,1,0,0,0,1,0,0,0,1,0,0,0,0,0,0,1,0,1,1,1,1,0,9,9,9,9,9,9,1,1,1,1,1,9,1,1,1,10,1,10,10,10,10,10,9,9,9,1,1,1,3,
3,1,1,1,9,1,1,9,1,1,1,10,10,1,10,10,1,1,9,1,1,1,10,10,10,10,10,1,1,1,0,0,0,0,0,0,1,0,0,0,0,0,0,0,0,0,0,0,0,1,0,0,0,1,0,0,0,1,0,0,0,0,0,0,1,0,1,0,0,0,0,9,9,9,9,9,9,9,9,9,9,9,9,9,10,1,10,1,10,10,10,10,10,9,1,9,1,1,1,3,
3,1,1,1,9,1,1,9,1,1,1,10,10,1,10,10,1,1,9,1,1,1,10,10,10,10,10,1,1,1,0,0,0,0,0,0,1,0,0,0,1,1,1,1,0,0,0,0,0,1,0,0,0,1,0,0,0,1,0,0,0,0,0,0,1,0,1,0,0,1,0,1,1,1,1,1,1,1,1,1,1,1,1,1,10,10,10,1,10,10,10,10,10,9,1,9,1,1,1,3,
3,1,1,1,9,1,1,9,1,1,1,1,9,1,9,1,1,1,9,1,1,1,1,1,1,1,1,1,1,1,0,0,0,0,0,0,1,0,0,0,0,0,0,1,0,0,0,0,0,1,0,0,0,1,0,0,0,1,0,0,0,0,0,0,1,0,1,1,1,1,0,1,1,1,1,1,1,1,1,1,1,1,1,1,1,1,9,1,9,9,9,1,1,9,1,9,1,1,1,3,
3,1,1,1,9,1,1,9,1,1,1,1,9,1,9,1,1,1,9,1,1,1,1,1,1,1,1,1,1,1,0,0,0,0,0,0,1,0,0,0,0,0,0,1,0,0,0,0,0,1,0,0,0,1,0,0,0,1,0,0,0,1,1,1,1,0,1,0,0,0,0,1,1,1,1,1,1,1,1,1,1,1,1,1,1,1,9,1,9,9,9,1,1,9,1,9,1,1,1,3,
3,1,1,1,9,1,1,9,1,1,1,1,9,1,9,9,9,9,9,9,9,9,9,9,9,9,9,9,9,9,9,9,1,0,0,0,1,0,0,0,0,0,0,1,0,0,0,0,0,1,0,0,0,1,0,0,0,1,0,0,0,1,0,0,0,0,1,0,1,1,1,1,1,1,1,1,1,1,1,1,1,1,1,1,1,1,9,1,9,9,9,1,1,9,1,9,1,1,1,3,
3,1,1,1,9,1,1,9,1,1,1,1,9,1,1,1,1,1,1,1,1,1,1,1,1,1,1,1,1,1,1,9,1,0,1,0,1,0,0,0,0,0,0,1,0,0,0,0,0,1,0,0,0,1,0,0,0,1,0,0,0,1,0,0,0,0,1,0,1,1,1,1,1,1,1,1,1,1,1,1,9,9,9,9,9,9,9,1,9,9,9,9,9,9,1,9,1,1,1,3,
3,1,1,1,9,1,1,9,1,1,1,1,9,9,9,9,9,9,9,9,9,9,9,9,9,9,9,9,9,9,9,9,1,0,1,0,1,0,0,0,0,0,0,1,0,0,0,0,0,1,0,0,0,1,0,0,0,1,0,0,0,1,0,1,1,1,1,0,1,1,1,1,1,1,1,1,1,1,1,1,9,9,9,9,1,1,1,1,1,1,1,9,1,9,1,9,1,1,1,3,
3,1,1,1,9,1,1,9,1,1,1,1,1,1,1,1,1,1,1,1,1,1,1,1,1,1,1,1,1,1,1,1,1,0,1,0,1,0,0,0,0,0,0,1,0,0,0,0,0,1,0,0,0,1,0,0,0,1,0,0,0,1,0,1,0,0,1,0,1,1,1,1,1,1,1,1,1,1,1,1,9,1,1,1,1,9,9,1,9,9,1,9,1,9,1,9,1,1,1,3,
3,1,1,1,9,1,1,9,1,1,1,1,1,1,1,1,1,1,1,1,1,1,1,1,1,1,1,1,1,1,1,1,1,0,1,0,1,0,0,0,0,0,0,1,0,0,0,0,0,1,0,0,0,1,0,0,0,1,0,0,0,1,0,1,0,0,1,0,1,1,1,1,1,1,1,1,1,1,1,1,9,1,9,9,9,9,1,1,9,9,1,1,1,9,1,9,1,1,1,3,
3,1,1,1,9,1,1,9,1,1,1,1,1,1,1,1,1,1,1,1,1,1,1,1,1,1,1,1,1,1,1,1,1,0,1,0,1,0,0,0,0,0,0,1,0,0,0,0,0,1,0,0,0,1,0,0,0,1,0,0,0,1,0,0,0,0,1,0,1,1,1,1,1,1,1,1,1,1,1,1,9,1,9,9,9,9,9,9,9,9,9,9,9,9,1,9,1,1,1,3,
3,1,1,1,9,1,1,9,1,1,1,1,1,1,1,1,1,1,1,1,1,1,1,1,1,1,1,1,1,1,1,1,1,0,1,0,1,0,0,0,0,0,0,1,0,0,0,0,0,1,0,0,0,1,0,0,0,1,0,0,0,1,1,1,1,0,1,0,1,1,1,1,1,1,1,1,1,1,1,1,5,1,1,1,9,1,1,1,9,1,9,9,9,1,1,9,1,1,1,3,
3,1,1,1,9,1,1,9,1,1,1,1,1,1,1,1,1,1,1,1,1,1,1,1,1,1,1,1,1,1,1,1,1,0,1,0,1,0,0,0,0,0,0,1,0,0,0,0,0,1,0,0,0,1,0,0,0,1,0,0,0,0,0,0,1,0,1,0,1,1,1,1,1,1,1,1,1,9,9,9,9,1,9,1,9,1,1,1,9,1,9,9,9,1,1,9,1,1,1,3,
3,1,1,1,9,1,1,9,1,1,1,1,1,1,1,1,1,1,1,1,1,1,1,1,1,1,1,1,1,1,1,1,1,0,1,0,1,0,0,0,0,0,0,1,0,0,0,0,0,1,0,0,0,1,0,0,0,1,0,0,0,0,1,0,1,0,1,0,9,9,9,9,9,1,1,1,1,9,1,1,9,1,9,9,9,1,1,1,9,1,9,9,9,1,1,9,1,1,1,3,
3,1,1,1,9,1,1,9,1,1,1,1,1,1,1,1,1,8,8,8,8,8,8,1,1,1,1,1,1,1,1,1,1,0,1,0,1,0,0,0,0,0,0,1,0,0,0,0,0,1,0,0,0,1,0,0,0,1,0,0,0,0,1,0,1,0,1,0,1,1,1,1,9,1,1,1,1,9,1,9,9,1,1,1,9,1,1,1,9,1,9,9,9,1,1,9,1,1,1,3,
3,1,1,1,9,1,1,9,1,1,1,1,1,1,1,1,1,8,8,8,8,8,8,1,1,1,1,1,1,1,1,1,1,0,1,0,1,0,0,0,0,0,0,1,0,0,0,0,0,1,0,0,0,1,0,0,0,1,0,0,0,0,1,0,1,0,1,0,1,1,1,1,9,1,1,1,1,9,1,9,9,9,9,1,9,1,1,9,9,9,9,9,9,1,1,9,1,1,1,3,
3,1,1,1,9,1,1,9,1,1,1,1,1,1,1,1,1,8,8,8,8,8,8,1,1,1,1,1,1,1,1,1,1,0,1,0,1,0,0,0,0,0,0,1,0,0,0,0,0,1,0,0,0,1,0,1,1,1,1,1,1,1,1,0,1,0,1,0,9,9,9,9,9,9,9,9,9,9,1,9,1,9,9,9,9,1,1,9,9,9,9,9,9,1,1,9,1,1,1,3,
3,1,1,1,9,1,1,9,1,1,1,1,1,1,1,1,1,8,8,8,8,8,8,1,1,1,1,1,1,1,1,1,1,0,1,0,1,0,0,0,0,0,0,1,0,0,0,0,0,1,0,0,0,1,0,1,0,1,0,0,0,0,0,0,1,0,1,1,1,1,1,1,1,1,1,1,1,9,1,9,1,9,1,1,1,1,1,9,9,9,1,1,1,1,1,9,1,1,1,3,
3,1,1,1,9,1,1,9,1,1,1,1,1,1,1,1,1,8,8,8,8,8,8,1,1,1,1,1,1,1,1,1,1,0,1,0,1,0,0,0,0,0,0,1,0,0,0,0,0,1,0,0,0,1,0,1,0,1,1,1,1,1,1,1,1,0,1,0,9,9,9,9,9,9,9,9,9,9,1,9,1,9,1,9,9,9,9,9,9,9,9,9,9,9,1,9,1,1,1,3,
3,1,1,1,9,1,1,9,1,1,1,1,1,1,1,1,1,8,8,8,8,8,8,1,1,1,1,1,1,1,1,1,1,0,1,0,1,0,0,0,0,0,0,1,0,0,0,0,0,1,0,1,0,1,0,1,0,0,0,0,0,0,0,0,0,0,1,0,1,1,1,1,1,1,1,1,1,9,1,9,1,9,1,9,9,9,1,1,1,9,1,9,1,9,1,9,1,1,1,3,
3,1,1,1,9,1,1,9,1,1,1,1,1,1,1,1,1,1,1,1,11,1,1,1,1,1,1,1,1,1,1,1,1,0,1,0,1,0,0,0,0,0,0,1,0,0,0,0,0,1,0,1,0,1,0,1,0,0,0,0,0,0,0,0,0,0,1,0,1,1,1,1,1,1,1,1,1,9,1,9,1,9,1,9,1,1,1,9,1,9,1,9,1,9,1,9,1,1,1,3,
3,1,1,1,9,1,1,9,9,9,9,9,9,9,9,9,9,9,9,9,9,9,9,9,9,0,0,0,0,0,0,0,0,0,1,0,1,0,0,0,0,0,0,1,0,0,0,0,0,1,0,1,0,1,0,0,0,0,0,0,0,0,0,0,0,0,1,0,0,0,0,0,0,0,0,0,9,9,1,9,1,9,9,9,1,9,1,9,1,9,1,9,1,9,1,9,1,1,1,3,
3,1,1,1,9,1,1,1,1,1,1,1,1,1,9,1,9,1,1,1,1,1,1,1,1,1,1,1,1,1,1,1,1,1,1,0,1,1,1,1,1,1,1,1,1,1,1,1,1,1,0,1,0,1,1,1,1,1,1,1,1,1,1,1,1,0,1,0,1,1,1,1,1,1,1,0,9,9,1,9,1,9,1,1,1,9,1,9,9,9,1,9,1,9,1,9,1,1,1,3,
3,1,1,1,9,1,1,1,1,1,1,1,1,1,9,1,9,1,9,1,9,9,9,9,9,0,0,0,0,0,0,1,0,0,0,0,0,0,0,0,0,0,0,0,0,0,0,0,0,1,0,1,0,0,0,0,0,0,0,0,0,0,0,0,0,0,1,0,1,0,0,0,0,0,0,0,9,9,1,9,1,9,9,9,9,9,1,9,1,9,1,9,1,9,1,9,1,1,1,3,
3,1,1,1,9,1,1,1,1,1,1,1,1,1,9,1,9,1,9,9,9,1,1,1,1,1,1,1,1,1,1,1,0,1,1,1,1,1,1,1,1,1,1,1,1,1,1,1,0,1,0,1,11,1,0,0,0,0,0,0,0,0,0,0,0,0,1,1,1,0,0,0,0,0,0,0,9,9,1,9,1,1,1,1,1,1,1,9,1,9,1,9,1,9,1,9,1,1,1,3,
3,1,1,1,11,1,1,1,1,1,1,1,1,1,9,1,9,1,1,1,9,9,9,9,9,0,0,0,0,0,0,0,0,0,0,0,0,0,0,0,0,0,0,0,0,0,0,1,0,1,0,1,8,1,0,0,0,0,0,0,0,0,0,0,0,0,0,0,0,0,0,0,0,0,0,0,9,9,1,9,1,9,9,9,9,9,9,9,1,9,1,9,1,9,1,9,1,1,1,3,
3,1,8,8,8,8,8,8,8,8,8,8,8,1,9,1,9,1,9,9,9,1,1,11,1,1,1,1,1,1,1,1,1,1,1,1,1,1,1,1,1,1,1,1,1,0,1,1,0,1,0,1,8,1,0,0,1,1,1,1,1,1,1,1,1,1,1,1,1,1,1,1,1,1,1,1,1,9,1,9,1,9,1,1,1,1,1,1,1,9,1,9,1,9,1,9,1,1,1,3,
3,1,8,8,8,8,8,8,8,8,8,8,8,1,9,1,9,1,1,1,9,1,8,8,8,8,8,1,1,1,1,1,1,1,1,1,1,1,1,1,1,1,1,1,1,0,0,1,0,1,0,1,8,1,0,0,1,1,1,1,1,1,1,1,1,1,1,1,8,8,8,8,8,1,1,1,1,5,1,1,1,9,1,1,1,1,1,1,1,9,1,9,1,9,1,9,1,1,1,3,
3,1,8,8,8,8,8,8,8,8,8,8,8,1,9,1,9,9,9,1,9,1,8,8,8,8,8,1,1,1,1,1,1,1,1,1,1,1,1,1,1,1,1,1,1,0,1,1,0,1,0,1,8,1,1,0,1,1,1,1,1,1,1,1,1,1,1,1,8,8,8,8,8,1,1,1,1,9,1,9,9,9,9,9,9,9,9,9,9,9,1,9,1,9,1,9,1,1,1,3,
3,1,8,8,8,8,8,8,8,8,8,8,8,1,9,1,9,1,9,1,9,1,8,8,8,8,8,1,1,1,1,1,1,1,1,1,1,1,1,1,1,1,1,1,1,0,0,1,0,1,0,1,8,1,0,0,1,1,1,1,1,1,1,1,1,1,1,1,8,8,8,8,8,1,1,1,1,9,1,9,1,1,1,1,1,1,1,1,1,1,1,1,1,9,1,9,1,1,1,3,
3,1,8,8,8,8,8,8,8,8,8,8,8,1,9,1,9,1,9,1,9,1,1,1,1,1,1,1,1,1,1,1,1,1,1,1,1,1,1,1,1,1,1,1,1,0,0,1,0,1,0,1,8,1,0,0,1,1,1,1,1,1,1,1,1,1,1,1,1,1,11,1,1,1,1,1,1,9,1,9,9,1,9,9,9,9,9,9,9,9,1,9,1,9,1,9,1,1,1,3,
3,1,8,8,8,8,8,8,8,8,8,8,8,1,9,9,9,1,1,1,9,9,9,9,9,9,9,9,9,9,9,9,9,9,9,9,0,0,0,0,0,0,0,0,0,0,0,1,0,1,0,1,8,1,0,0,0,0,0,0,0,0,0,0,0,9,9,9,9,9,9,9,9,9,9,9,9,9,1,9,9,1,9,1,1,1,9,1,1,9,1,9,1,9,1,9,1,1,1,3,
3,1,8,8,8,8,8,8,8,8,8,8,8,1,9,1,9,1,9,9,9,1,1,1,1,1,1,1,1,1,1,1,1,1,1,1,1,1,1,1,1,0,1,0,1,1,0,1,0,1,0,1,8,1,0,1,1,1,1,1,1,1,1,1,1,1,1,1,9,1,1,1,1,1,1,1,9,9,1,1,1,1,9,1,9,1,9,1,1,9,1,9,1,9,1,9,1,1,1,3,
3,1,8,8,8,8,8,8,8,8,8,8,8,1,9,1,1,1,1,9,9,9,9,9,9,9,9,1,9,9,9,9,9,9,9,1,0,1,0,0,1,0,1,0,1,0,0,1,0,1,0,1,8,1,0,0,0,0,0,0,0,1,0,0,0,9,9,9,9,9,9,9,9,9,9,1,9,9,9,9,9,9,9,1,9,1,9,1,1,9,1,9,1,9,1,9,1,1,1,3,
3,1,8,8,8,8,8,8,8,8,8,8,8,12,9,1,9,9,9,9,1,1,1,1,1,9,9,1,9,1,1,1,1,1,1,1,0,1,0,1,1,0,1,0,1,1,0,1,0,1,0,1,8,1,1,1,1,1,1,1,1,1,1,1,1,1,1,1,1,1,1,1,1,1,1,1,1,1,1,1,1,1,1,1,9,1,9,1,1,9,1,9,1,9,1,9,1,1,1,3,
3,1,8,8,8,8,8,8,8,8,8,8,8,1,9,1,1,1,1,9,1,9,9,9,1,9,9,1,9,9,9,9,9,9,9,9,0,1,0,0,0,0,1,0,1,0,0,1,0,1,0,1,8,8,8,8,8,8,8,8,8,1,0,0,0,9,9,9,9,9,9,9,9,9,9,1,9,9,9,9,9,9,1,9,9,9,9,1,1,9,9,9,1,9,1,9,1,1,1,3,
3,1,8,8,8,8,8,8,8,8,8,8,8,1,9,9,9,9,1,9,1,9,9,9,1,9,9,1,1,1,1,1,1,1,1,1,0,1,0,1,1,1,1,0,1,1,0,1,0,1,0,1,8,8,8,8,8,8,8,8,8,1,0,1,1,1,1,1,1,1,1,1,1,1,1,1,9,9,9,9,9,9,1,1,1,1,9,1,1,9,1,1,1,9,1,9,1,1,1,3,
3,1,8,8,8,8,8,8,8,8,8,8,8,1,9,9,9,9,1,9,1,9,9,9,1,9,9,9,9,9,9,9,9,9,9,9,0,1,0,1,0,0,1,0,1,0,0,1,0,1,0,1,1,1,1,8,8,8,8,8,8,1,0,1,0,9,9,9,9,9,9,9,9,9,9,9,9,9,9,9,9,9,9,9,9,9,9,1,1,9,9,9,9,9,1,9,1,1,1,3,
3,1,8,8,8,8,8,8,8,8,8,8,8,1,9,1,1,9,1,9,9,9,9,9,1,9,1,1,1,1,1,1,1,1,1,1,0,1,1,1,0,0,1,0,1,1,0,1,0,1,0,0,0,0,1,8,8,8,8,8,8,1,0,1,0,1,1,1,1,1,11,1,1,1,1,1,1,1,9,1,1,9,1,1,1,1,9,1,1,1,1,1,1,9,1,9,1,1,1,3,
3,1,8,8,8,8,8,8,8,8,8,8,8,1,9,1,1,9,1,9,9,9,9,9,1,9,1,1,1,1,1,1,1,1,1,1,0,0,0,1,0,0,1,0,1,0,0,1,0,1,0,0,0,0,1,8,8,8,8,8,8,1,0,1,0,9,1,1,8,8,8,8,8,8,1,1,1,1,9,1,1,9,1,1,1,1,9,1,1,1,1,1,1,9,1,9,1,1,1,3,
3,1,8,8,8,8,8,8,8,8,8,8,8,1,9,1,1,9,1,9,9,9,9,9,1,9,1,1,1,1,1,1,1,1,1,1,0,0,0,1,0,0,1,1,1,1,1,1,0,1,0,1,1,1,1,1,1,1,1,1,1,1,0,0,0,9,1,1,8,8,8,8,8,8,1,1,1,1,9,1,1,9,1,1,1,1,9,1,1,1,1,1,1,9,1,1,1,1,1,3,
3,1,8,8,8,8,8,8,8,8,8,8,8,1,9,1,1,9,1,1,1,1,1,9,1,9,1,1,1,1,1,1,1,1,1,1,0,0,0,1,0,0,1,0,0,0,0,0,0,1,0,1,0,0,1,0,0,0,0,0,0,0,0,0,0,9,1,1,8,8,8,8,8,8,1,1,1,1,9,1,1,9,1,1,1,1,9,1,1,1,1,1,1,9,1,1,1,1,1,3,
3,1,8,8,8,8,8,8,8,8,8,8,8,1,9,1,1,9,9,9,1,9,1,9,1,9,1,1,1,1,1,1,1,1,1,1,0,1,1,1,1,0,1,0,1,1,1,1,0,1,0,1,0,0,1,0,0,0,0,0,0,0,0,0,0,9,1,1,8,8,8,8,8,8,1,1,1,1,9,9,9,9,9,9,9,9,9,1,1,1,1,1,1,9,1,1,1,1,1,3,
3,1,8,8,8,8,8,8,8,8,8,8,8,1,9,1,1,9,1,1,1,9,1,9,1,9,1,1,1,1,1,1,1,1,1,1,0,1,0,1,0,0,1,0,1,0,0,0,0,1,0,1,1,0,1,0,0,0,0,0,0,0,0,0,0,9,1,1,8,8,8,8,8,8,1,1,1,1,1,1,1,9,1,1,1,1,9,1,1,1,1,1,1,9,1,1,1,1,1,3,
3,1,1,1,1,1,1,1,1,1,1,1,1,1,9,1,1,9,9,9,9,9,1,9,1,9,1,1,1,1,1,1,1,1,1,1,0,0,0,0,0,0,1,1,1,1,1,1,0,1,0,1,0,0,1,0,0,0,0,0,0,0,0,0,0,9,1,1,8,8,8,8,8,8,1,1,1,1,1,1,1,9,1,1,1,1,9,1,1,1,1,1,1,9,1,1,1,1,1,3,
3,1,1,1,1,1,1,1,1,1,1,1,1,1,9,1,1,9,1,9,1,9,1,9,1,9,1,1,1,1,1,1,1,1,1,1,9,1,1,0,0,0,1,0,1,0,0,0,0,1,0,1,0,0,1,0,0,0,0,0,0,0,1,1,1,9,1,1,1,1,1,1,1,1,1,1,1,1,1,1,1,9,1,1,1,1,9,1,1,1,1,1,1,9,1,1,1,1,1,3,
3,1,1,1,1,1,1,1,1,1,1,1,1,1,9,1,1,9,1,9,1,9,1,9,1,9,1,1,1,1,1,1,1,1,1,1,9,1,1,0,1,1,1,0,1,1,1,1,0,1,0,1,0,0,1,0,0,0,0,0,0,0,1,1,1,9,1,1,1,1,1,1,1,1,1,1,1,1,1,1,1,9,1,1,1,1,9,9,9,9,9,9,9,9,1,1,1,1,1,3,
3,1,1,1,1,1,1,1,1,1,1,1,1,1,11,1,1,9,1,1,1,1,1,1,1,9,1,1,1,1,1,1,1,1,1,1,9,1,1,0,1,0,1,0,1,0,0,0,0,1,0,1,0,1,1,1,1,1,1,0,0,0,1,1,1,9,1,1,1,1,1,1,1,1,1,1,1,1,1,1,1,9,1,1,1,1,9,1,1,1,1,1,1,1,1,1,1,1,1,3,
3,1,1,1,1,1,1,1,1,1,8,8,8,8,8,8,1,9,9,9,1,9,1,9,9,9,1,1,1,1,1,1,1,1,1,1,9,1,1,0,1,0,1,0,1,1,1,1,0,1,0,1,0,0,1,0,0,0,1,0,0,0,1,1,1,9,1,1,1,1,1,1,1,1,1,1,1,1,1,1,1,9,1,1,1,1,9,1,1,1,1,1,1,1,1,1,1,1,1,3,
3,1,1,1,1,1,1,1,1,1,8,8,8,8,8,8,1,9,1,9,1,9,1,9,1,9,1,1,1,1,1,1,1,1,1,1,9,1,1,0,0,0,1,0,0,0,0,0,0,1,0,1,0,0,1,0,1,0,1,0,0,0,1,1,1,9,1,1,1,1,1,1,1,1,1,1,1,1,1,1,1,9,1,1,1,1,9,1,1,1,1,1,1,1,1,1,1,1,1,3,
3,1,1,1,1,1,1,1,1,1,8,8,8,8,8,8,1,9,1,1,1,9,1,9,1,9,9,9,9,9,9,9,9,9,5,9,9,9,9,0,1,1,1,1,1,1,1,1,1,1,0,1,0,0,1,0,1,0,1,0,0,0,9,9,9,9,9,9,9,9,9,9,9,1,1,1,1,1,1,1,1,9,1,1,1,1,9,1,1,1,1,1,1,1,1,1,1,1,1,3,
3,1,1,1,1,1,1,1,1,1,8,8,8,8,8,8,1,9,1,9,1,9,1,9,1,9,1,1,1,1,1,1,1,1,1,9,1,1,1,0,1,0,1,0,0,0,0,0,0,0,0,1,0,0,1,0,1,0,0,0,0,0,1,1,1,1,9,1,1,1,9,9,9,9,9,9,9,9,9,9,9,9,1,1,1,1,9,1,1,1,1,1,1,1,1,1,1,1,1,3,
3,1,1,1,1,1,1,1,1,1,8,8,8,8,8,8,1,9,1,9,1,9,9,9,9,9,9,9,9,9,9,9,9,9,9,9,1,9,1,0,1,0,1,0,0,0,0,0,1,1,1,1,0,0,1,0,1,1,1,1,1,1,1,9,9,1,9,9,9,1,9,9,1,1,1,1,9,9,1,1,1,9,1,1,1,1,9,1,1,1,1,1,1,1,1,1,1,1,1,3,
3,1,1,1,1,1,1,1,1,1,8,8,8,8,8,8,1,9,1,9,1,1,1,1,1,1,1,1,1,1,1,1,1,1,1,1,1,9,9,0,0,0,1,0,0,0,0,0,0,0,0,0,0,0,1,0,0,0,0,0,0,0,9,9,9,1,9,9,9,1,1,1,1,9,9,1,1,9,1,9,9,9,1,1,1,1,9,1,1,1,1,1,1,1,1,1,1,1,1,3,
3,1,1,1,1,1,1,1,1,1,1,1,1,1,1,1,1,9,1,9,9,9,9,9,9,9,9,9,9,9,9,9,9,1,9,9,1,1,1,1,0,0,1,0,0,0,1,0,1,1,1,1,1,0,1,1,1,1,1,1,1,1,1,1,1,1,9,9,9,1,9,9,9,9,9,9,9,9,1,9,9,9,1,1,1,1,9,1,1,1,1,1,1,1,1,1,1,1,1,3,
3,1,1,1,1,1,1,1,1,1,1,1,1,1,1,1,1,9,1,9,1,1,9,1,1,1,1,1,1,1,1,1,1,1,9,9,1,9,9,1,0,0,1,0,0,0,1,0,1,0,1,0,1,0,0,0,0,0,1,0,0,0,9,9,9,1,1,1,1,1,1,1,1,1,1,1,1,1,1,9,9,9,1,1,1,1,9,1,1,1,1,1,1,1,1,1,1,1,1,3,
3,1,1,1,1,1,1,1,1,1,1,1,1,1,1,1,1,9,1,1,1,9,9,9,9,9,9,9,9,9,9,9,9,9,9,9,1,9,9,1,0,0,1,0,0,0,1,0,1,0,1,0,1,0,0,0,1,0,1,0,0,0,9,9,9,1,9,9,9,1,9,9,9,9,9,9,9,9,9,9,9,9,1,1,1,1,9,1,1,1,1,1,1,1,1,1,1,1,1,3,
3,1,1,1,1,1,1,1,1,1,1,1,1,1,1,1,1,9,1,9,9,9,1,9,1,1,1,1,1,1,1,1,1,1,1,1,1,9,9,1,1,1,1,1,1,1,1,0,1,0,1,0,1,1,1,1,1,0,1,0,0,0,9,9,9,1,9,9,9,1,9,1,9,9,9,9,9,9,9,1,9,9,1,1,1,1,9,1,1,1,1,1,1,1,1,1,1,1,1,3,
3,1,1,1,1,1,1,1,1,1,1,1,1,1,1,1,1,9,1,1,1,9,1,9,9,9,9,9,9,9,9,9,9,9,9,9,9,9,9,0,0,0,1,0,0,0,1,0,1,0,1,0,0,0,0,0,0,0,1,0,0,0,9,9,9,1,1,1,9,1,9,1,9,1,1,1,9,1,1,1,9,1,1,1,1,1,9,1,1,1,1,1,1,1,1,1,1,1,1,3,
3,1,1,1,1,1,8,8,8,8,8,8,8,8,8,8,1,9,1,9,1,9,1,9,1,9,1,1,9,1,9,9,9,9,1,1,9,1,1,0,1,1,1,0,0,0,1,0,1,0,1,1,1,1,1,1,1,0,1,0,0,0,1,1,9,9,9,1,9,1,9,1,9,1,1,1,9,1,9,9,9,1,1,1,10,10,10,10,10,10,10,10,10,10,10,10,10,1,1,3,
3,1,1,1,1,1,8,8,8,8,8,8,8,8,8,8,1,9,1,9,1,1,1,1,1,9,1,1,9,1,1,1,1,9,9,1,9,1,1,0,0,0,0,0,0,0,1,0,0,0,0,0,0,0,0,0,0,0,1,0,0,0,1,1,9,1,9,1,9,1,9,1,9,1,1,1,9,1,9,1,9,1,1,1,10,1,1,1,10,1,10,1,10,1,1,1,10,1,1,3,
3,1,1,1,1,1,8,8,8,8,8,8,8,8,8,8,1,9,1,9,9,9,9,9,9,9,1,1,9,9,9,9,1,9,9,1,9,1,1,0,1,1,1,1,1,1,1,1,1,1,1,1,1,1,1,1,1,1,1,0,0,0,1,1,9,1,1,1,9,1,9,1,9,9,9,9,9,1,9,1,9,9,9,9,10,10,10,1,10,1,10,1,10,10,10,1,10,1,1,3,
3,1,1,1,1,1,8,8,8,8,8,8,8,8,8,8,1,9,1,1,1,1,1,1,1,9,1,1,9,1,9,9,1,1,1,1,9,1,1,0,1,0,0,0,0,0,0,0,0,0,5,0,0,0,0,0,0,0,0,0,0,0,1,1,9,9,9,9,9,1,9,1,1,1,9,1,1,1,9,1,1,1,1,1,10,1,1,1,10,1,10,1,10,1,10,1,10,1,1,3,
3,1,1,1,1,1,8,8,8,8,8,8,8,8,8,8,1,9,1,9,9,9,9,9,9,9,1,1,9,1,9,9,9,9,1,9,9,1,1,0,1,1,1,1,1,1,1,1,1,0,5,0,0,0,0,0,0,0,0,0,0,0,1,1,9,9,9,9,9,1,9,9,1,9,9,1,9,9,9,1,9,9,9,9,10,1,10,10,10,1,10,1,10,1,10,1,10,1,1,3,
3,1,1,1,1,1,8,8,8,8,8,8,8,8,8,8,12,9,1,1,1,1,1,1,1,9,1,1,9,1,9,9,9,9,1,9,9,1,1,0,0,0,0,0,0,0,0,0,0,0,5,0,0,0,0,0,0,0,0,0,0,0,9,9,9,1,1,1,1,1,1,1,1,1,1,1,1,1,1,1,9,1,1,9,1,1,10,1,1,1,10,1,10,1,10,1,10,1,1,3,
3,1,1,1,1,1,8,8,8,8,8,8,8,8,8,8,1,9,1,9,9,9,9,9,9,9,1,1,9,1,9,9,9,9,1,9,9,1,1,1,1,1,1,1,1,1,9,9,9,9,5,9,9,9,9,1,1,1,1,1,1,1,1,1,9,1,9,9,9,1,9,9,1,9,9,1,9,9,9,9,9,5,9,9,1,10,10,1,10,10,10,1,1,1,1,1,10,1,1,3,
3,1,1,1,1,1,8,8,8,8,8,8,8,8,8,8,1,9,1,1,1,1,1,1,1,9,1,1,9,1,1,1,1,1,1,1,9,1,1,1,1,1,1,1,1,1,9,1,1,1,1,1,1,1,9,1,1,1,1,1,1,1,1,1,9,1,9,1,9,1,9,1,1,9,1,1,1,1,1,1,1,1,1,1,1,1,1,1,1,1,10,1,10,1,10,10,10,1,1,3,
3,1,1,1,1,1,8,8,8,8,8,8,8,8,8,8,1,9,1,9,9,9,9,9,9,9,1,1,9,9,1,9,9,9,1,9,9,1,1,1,1,1,1,1,1,1,9,9,9,9,9,5,9,9,9,1,1,1,1,1,1,1,1,1,9,1,9,1,1,1,9,1,9,9,9,9,9,9,1,9,9,9,9,9,10,10,10,1,10,10,10,10,10,1,10,1,10,1,1,3,
3,1,1,1,1,1,8,8,8,8,8,8,8,8,8,8,1,9,1,1,1,1,1,1,1,9,1,1,9,9,1,1,1,9,1,9,9,1,1,1,1,1,1,1,1,1,9,1,1,1,1,1,9,1,9,1,1,1,1,1,1,1,1,1,9,1,9,1,9,1,9,1,9,1,1,1,1,1,1,9,1,1,9,1,1,1,1,1,1,1,1,1,1,1,1,1,10,1,1,3,
3,1,1,1,1,1,8,8,8,8,8,8,8,8,8,8,1,9,9,9,9,9,9,9,9,9,9,9,9,9,9,9,9,9,1,9,9,9,9,9,9,9,9,9,9,9,9,9,9,9,9,1,9,1,9,1,1,1,1,1,1,1,1,1,9,1,9,1,9,1,9,1,9,9,9,9,9,9,9,9,9,5,9,9,10,10,10,1,10,10,1,10,10,10,10,10,10,1,1,3,
3,1,1,1,1,1,1,1,1,1,1,11,1,1,1,1,1,9,1,1,1,1,1,1,1,9,1,9,1,1,1,1,1,9,1,1,1,1,1,1,1,1,1,1,1,1,1,1,1,1,1,1,9,1,9,9,9,9,9,9,9,1,1,1,9,1,9,9,9,1,9,1,9,1,1,1,1,1,1,1,1,1,1,1,10,10,10,1,1,10,1,1,1,1,1,1,10,1,1,3,
3,1,1,1,1,1,1,1,1,1,1,9,1,1,1,1,1,9,1,1,1,1,1,1,1,9,1,9,1,1,1,1,1,9,9,9,9,9,9,9,9,9,9,9,9,9,9,9,9,9,9,9,9,1,9,1,1,1,1,1,9,1,1,1,9,1,9,1,9,1,9,1,9,1,1,1,1,1,1,1,1,1,1,1,10,10,10,10,10,10,10,10,10,10,10,10,10,1,1,3,
3,1,1,1,1,1,1,1,1,1,1,9,1,1,1,1,1,9,1,1,1,1,1,1,1,9,1,9,1,1,1,1,1,9,1,1,1,1,1,1,1,1,1,1,1,1,1,1,1,1,1,1,1,1,5,1,1,1,1,1,9,1,1,1,9,1,9,1,9,1,9,1,9,1,8,8,8,8,8,8,1,1,1,1,1,9,1,1,1,1,1,1,1,1,9,1,1,1,1,3,
3,1,1,1,1,1,1,1,1,1,1,9,1,1,1,1,1,9,1,1,1,1,1,1,1,9,1,9,1,1,1,1,1,9,9,9,9,9,9,9,9,9,9,9,9,9,9,9,9,9,1,9,9,1,9,1,1,1,1,1,9,1,1,1,9,1,9,1,1,1,9,1,9,1,8,8,8,8,8,8,1,1,1,1,1,9,1,1,1,1,1,1,1,1,9,1,1,1,1,3,
3,1,1,1,1,1,1,1,1,1,1,9,1,1,1,1,1,9,1,1,1,1,1,1,1,9,1,9,1,1,1,1,1,9,1,1,1,1,1,1,1,1,1,1,1,1,1,1,9,9,9,9,9,1,9,1,1,1,1,1,9,1,1,1,9,9,9,9,9,1,9,1,9,1,8,8,8,8,8,8,1,1,1,1,1,9,1,1,1,1,1,1,1,1,9,1,1,1,1,3,
3,1,1,1,1,1,1,1,1,1,1,9,9,9,9,9,9,9,1,1,1,1,1,1,1,9,9,9,1,1,1,1,1,9,1,9,9,9,9,9,9,9,9,9,9,9,9,1,1,1,1,1,1,1,9,1,1,1,1,1,9,1,1,1,9,1,1,1,9,1,9,9,9,1,8,8,8,8,8,8,12,9,9,9,9,9,9,9,9,9,9,9,9,9,9,1,1,1,1,3,
3,1,1,1,1,1,1,1,1,1,1,1,1,1,11,1,1,1,1,1,1,1,1,1,1,9,1,9,1,1,1,1,1,9,1,9,1,1,1,1,1,1,1,1,1,1,1,1,9,9,9,9,9,9,9,9,9,9,1,1,9,9,9,9,9,1,9,1,9,1,9,1,9,1,8,8,8,8,8,8,1,1,1,1,1,9,1,1,9,1,1,1,1,1,9,1,1,1,1,3,
3,1,1,1,1,1,1,1,1,1,1,1,8,8,8,8,1,1,1,1,1,1,1,1,1,9,1,9,1,8,8,8,1,9,9,9,9,9,9,9,9,9,9,9,9,9,9,9,9,9,9,9,9,9,9,1,1,9,1,1,1,1,1,1,9,1,9,1,1,1,1,1,9,1,8,8,8,8,8,8,1,1,1,1,1,9,1,1,9,1,1,1,1,1,9,1,1,1,1,3,
3,1,1,1,1,1,1,1,1,1,1,1,8,8,8,8,1,1,1,1,1,1,1,1,1,9,1,9,1,8,8,8,1,1,1,1,1,1,1,11,1,1,1,1,1,1,1,1,1,1,1,1,1,1,1,1,1,9,1,1,1,1,1,1,9,1,9,9,9,9,5,9,9,1,1,1,11,1,1,1,1,1,9,9,9,9,9,9,9,9,9,9,9,9,9,1,1,1,1,3,
3,1,1,1,1,1,1,1,1,1,1,1,8,8,8,8,1,1,8,8,8,8,8,8,1,9,1,9,12,8,8,8,1,1,1,8,8,8,8,8,8,8,8,8,8,1,1,1,1,1,1,1,1,1,1,1,1,9,1,1,1,1,1,1,9,1,9,1,1,1,1,1,9,1,10,10,10,10,10,1,1,1,9,1,1,9,1,1,9,1,1,1,1,1,1,1,1,1,1,3,
3,1,1,1,1,1,1,1,1,1,1,1,8,8,8,8,1,1,8,8,8,8,8,8,1,9,1,9,1,8,8,8,1,1,1,8,8,8,8,8,8,8,8,8,8,1,1,1,1,1,1,1,1,1,1,1,1,9,1,1,1,1,1,1,9,9,9,9,9,9,9,9,9,1,10,10,10,10,10,1,1,1,9,1,1,9,1,1,9,1,1,1,1,1,1,1,1,1,1,3,
3,1,1,1,1,1,1,1,1,1,1,1,8,8,8,8,1,1,8,8,8,8,8,8,1,9,1,9,1,8,8,8,1,1,1,8,8,8,8,8,8,8,8,8,8,1,1,1,1,1,1,1,1,1,1,1,1,9,1,1,1,1,1,1,1,1,1,1,1,1,1,1,9,9,10,10,10,10,10,1,1,1,9,1,1,9,1,1,9,1,1,1,1,1,1,1,1,1,1,3,
3,1,1,1,1,1,1,1,1,1,1,1,8,8,8,8,1,1,8,8,8,8,8,8,12,9,1,9,1,1,1,1,1,1,1,8,8,8,8,8,8,8,8,8,8,1,1,1,1,1,1,1,1,1,1,1,1,9,1,8,8,8,8,8,8,1,1,1,1,1,1,1,9,1,10,10,10,10,10,1,1,1,9,1,1,11,1,1,11,1,1,1,1,1,1,1,1,1,1,3,
3,1,1,1,1,1,1,1,1,1,1,1,1,1,1,1,1,1,8,8,8,8,8,8,1,9,9,9,1,1,1,1,1,1,1,8,8,8,8,8,8,8,8,8,8,1,1,9,9,9,9,9,9,9,9,9,9,9,1,8,8,8,8,8,8,12,9,9,9,9,9,9,9,1,10,10,10,10,10,1,1,1,9,1,1,8,8,8,8,8,8,1,1,1,1,1,1,1,1,3,
3,1,1,1,1,1,1,1,1,1,1,1,1,1,1,1,1,1,8,8,8,8,8,8,1,9,1,9,1,1,1,1,1,1,1,8,8,8,8,8,8,8,8,8,8,1,1,9,1,1,1,1,1,1,1,1,1,9,1,8,8,8,8,8,8,1,9,1,1,1,1,1,1,1,1,1,9,1,1,1,1,1,9,9,12,8,8,8,8,8,8,1,1,1,1,1,1,1,1,3,
3,1,1,1,1,1,1,1,1,1,1,1,1,1,1,1,1,1,1,1,1,1,1,1,1,5,1,9,1,1,1,1,1,1,1,8,8,8,8,8,8,8,8,8,8,1,1,9,1,1,1,9,9,9,9,9,9,9,1,8,8,8,8,8,8,1,9,1,1,1,1,1,1,1,1,1,9,1,1,1,1,1,9,1,1,8,8,8,8,8,8,1,1,1,1,1,1,1,1,3,
3,1,1,1,1,1,1,1,1,1,1,1,1,1,1,1,1,8,8,8,8,8,8,1,1,9,1,9,1,1,1,1,1,1,1,8,8,8,8,8,8,8,8,8,8,1,1,9,1,1,1,9,1,1,1,1,1,9,1,8,8,8,8,8,8,1,9,1,1,1,1,1,1,1,1,1,9,1,1,1,1,1,9,1,1,8,8,8,8,8,8,1,1,1,1,1,1,1,1,3,
3,1,1,1,1,1,1,1,1,1,1,1,1,1,1,1,1,8,8,8,8,8,8,1,1,9,9,9,1,1,1,1,1,1,1,8,8,8,8,8,8,8,8,8,8,1,1,9,1,1,1,9,1,1,1,1,1,9,1,8,8,8,8,8,8,1,9,1,1,1,1,1,1,1,1,1,9,9,9,9,9,9,9,1,1,8,8,8,8,8,8,1,1,1,1,1,1,1,1,3,
3,1,1,1,1,8,8,8,8,8,8,1,1,1,1,1,1,8,8,8,8,8,8,12,9,9,1,9,9,9,9,9,9,9,12,8,8,8,8,8,8,8,8,8,8,1,1,9,9,9,9,9,1,1,1,1,1,9,1,1,1,1,1,1,1,1,9,1,1,1,1,1,1,1,1,1,1,1,1,9,1,1,9,1,1,8,8,8,8,8,8,1,1,1,1,1,1,1,1,3,
3,1,1,1,1,8,8,8,8,8,8,1,1,1,1,1,1,8,8,8,8,8,8,1,1,9,1,9,1,1,1,1,1,1,1,8,8,8,8,8,8,8,8,8,8,1,1,9,1,1,1,1,1,1,1,1,1,9,1,1,1,1,1,1,1,1,9,1,1,1,1,1,1,1,1,1,1,1,1,9,1,1,9,1,1,1,1,1,11,1,1,1,1,1,1,1,1,1,1,3,
3,1,1,1,1,8,8,8,8,8,8,1,1,1,1,1,1,8,8,8,8,8,8,1,1,9,1,9,1,1,1,1,1,1,1,1,1,1,1,1,1,1,1,1,1,1,1,9,1,1,1,1,1,1,1,1,1,9,1,1,1,1,1,1,1,1,9,1,1,1,1,1,1,1,1,1,1,1,1,9,9,9,9,9,9,9,9,9,9,1,1,1,1,1,1,1,1,1,1,3,
3,1,1,1,1,8,8,8,8,8,8,1,1,1,1,1,1,8,8,8,8,8,8,1,1,5,1,9,1,1,1,1,1,1,1,1,1,1,1,1,1,1,1,1,1,1,1,9,1,1,1,1,1,1,1,1,1,9,1,1,1,1,1,1,1,1,9,1,1,1,1,1,1,1,1,1,1,1,1,1,1,1,9,1,1,9,1,1,1,1,1,1,1,1,1,1,1,1,1,3,
3,1,1,1,1,8,8,8,8,8,8,1,1,1,1,1,1,1,1,1,11,1,1,1,1,9,1,9,1,1,1,1,1,1,1,1,1,1,1,1,1,1,1,1,1,1,1,9,1,1,1,1,1,1,1,1,10,10,10,1,1,1,1,1,1,10,10,10,1,1,1,1,1,1,1,1,1,1,1,1,1,1,9,1,1,9,1,1,1,1,1,1,1,1,1,1,1,1,1,3,
3,1,1,1,1,8,8,8,8,8,8,12,9,9,9,9,9,9,9,9,9,9,9,9,9,9,1,9,1,1,1,1,1,1,1,1,1,1,1,1,1,1,1,1,1,1,1,9,1,1,1,1,1,1,1,1,10,10,10,9,9,9,9,9,9,10,10,10,1,1,1,1,1,1,1,1,1,1,1,9,9,9,9,1,1,9,9,9,9,1,1,1,1,1,1,1,1,1,1,3,
3,1,1,1,1,1,1,11,1,1,1,1,1,1,1,1,9,1,1,1,1,1,1,1,1,9,1,9,1,1,1,1,1,1,1,1,1,1,1,1,1,1,1,1,1,1,1,9,1,1,1,1,1,1,1,1,10,10,10,1,1,1,1,1,9,10,10,10,1,1,1,1,1,1,1,1,1,1,1,9,1,1,1,1,1,1,1,1,9,1,1,1,1,1,1,1,1,1,1,3,
3,1,1,1,1,10,10,10,10,10,1,1,1,1,1,1,9,1,9,9,9,9,9,9,9,9,9,9,1,1,1,1,1,1,1,1,9,9,9,9,9,9,9,9,9,9,9,9,1,1,1,1,1,1,1,1,1,1,1,1,1,1,1,1,9,1,1,1,1,1,1,1,1,1,1,1,1,1,1,9,1,1,1,1,1,1,1,1,9,1,1,1,1,1,1,1,1,1,1,3,
3,1,1,1,1,10,10,10,10,10,9,9,9,9,9,9,9,1,9,1,1,1,1,9,1,1,1,1,1,1,1,1,1,1,1,1,9,1,1,1,1,1,9,9,9,1,1,1,1,1,1,1,1,1,1,1,1,1,1,1,1,1,1,1,9,1,1,1,1,1,1,1,1,1,1,1,9,9,9,9,1,1,1,1,1,1,1,1,9,1,9,9,9,9,9,1,1,1,1,3,
3,1,1,1,1,10,10,10,10,10,9,9,9,9,9,9,9,1,9,1,1,1,1,9,1,1,1,1,1,1,1,1,1,1,1,1,9,1,1,1,1,1,9,9,9,1,1,1,1,1,1,1,1,1,1,1,1,1,1,1,1,1,1,1,9,1,1,1,1,1,1,1,1,1,1,1,9,1,1,9,1,1,1,1,1,1,1,1,9,1,9,9,1,1,9,1,1,1,1,3,
3,1,1,1,1,10,10,10,10,10,9,9,9,9,9,9,9,1,9,1,1,1,1,11,1,1,1,1,1,1,1,1,1,1,1,1,9,1,1,1,1,1,9,9,9,1,1,1,1,1,1,1,1,1,1,1,1,1,1,1,1,1,1,1,9,1,1,1,1,1,1,1,1,1,1,1,9,1,1,9,9,9,9,9,9,9,9,9,9,9,9,9,1,9,9,1,1,1,1,3,
3,1,1,1,1,10,10,10,10,10,1,1,1,1,1,1,9,1,9,1,1,8,8,8,8,8,8,1,8,8,8,8,8,8,1,1,9,1,1,1,1,1,9,9,9,1,1,1,1,1,1,1,1,1,1,1,1,1,1,1,1,1,1,1,9,1,1,1,1,1,1,1,1,1,1,1,9,1,1,9,1,1,9,1,1,1,1,1,1,1,9,9,1,9,9,1,1,1,1,3,
3,1,1,1,1,1,9,9,9,1,1,1,1,1,1,1,9,1,9,1,1,8,8,8,8,8,8,1,8,8,8,8,8,8,1,1,9,1,1,1,1,10,10,10,10,10,1,1,1,1,1,1,1,1,1,1,1,1,1,1,1,1,1,1,9,1,1,1,1,1,1,1,1,1,1,1,9,1,1,9,1,1,9,1,1,1,1,1,1,1,9,9,1,9,9,1,1,1,1,3,
3,1,1,1,1,1,9,9,9,1,1,1,1,1,1,1,9,1,9,1,1,8,8,8,8,8,8,1,8,8,8,8,8,8,1,1,9,1,1,1,1,10,1,10,10,10,9,9,9,9,9,9,9,9,9,9,9,5,9,9,9,9,9,9,9,9,1,1,1,1,1,1,1,1,1,1,9,1,1,9,1,1,9,1,1,1,1,1,1,1,9,9,1,9,9,1,1,1,1,3,
3,1,1,1,1,1,9,9,9,1,1,1,1,1,1,1,9,1,9,1,1,8,8,8,8,8,8,1,8,8,8,8,8,8,12,9,9,9,9,9,9,10,1,1,1,1,1,1,1,1,1,1,1,1,1,1,1,1,1,1,1,1,1,1,1,9,9,9,9,9,9,9,9,9,9,9,9,1,1,9,9,9,9,9,9,9,9,9,9,9,9,9,1,9,9,1,1,1,1,3,
3,1,1,1,1,1,9,9,9,9,5,9,1,1,1,1,9,1,9,1,1,8,8,8,8,8,8,1,8,8,8,8,8,8,1,1,1,1,1,1,1,10,1,10,10,10,9,9,9,9,9,9,9,9,9,9,9,9,9,9,9,9,9,9,9,9,1,1,1,9,1,1,1,9,1,1,1,1,1,9,1,1,9,1,1,1,1,1,1,10,10,10,1,10,10,10,1,1,1,3,
3,1,1,1,1,1,9,1,1,1,1,9,1,1,1,1,9,1,9,1,1,8,8,8,8,8,8,1,8,8,8,8,8,8,1,1,1,1,1,1,1,10,10,10,10,10,1,1,1,1,1,1,1,1,1,1,1,1,1,1,1,1,1,1,9,1,1,1,1,9,1,1,1,9,1,1,1,1,1,9,1,1,9,1,1,1,1,1,1,10,10,10,1,10,10,10,1,1,1,3,
3,1,1,1,1,1,9,9,9,9,1,9,1,1,1,10,10,1,10,10,1,1,1,1,11,1,1,1,1,1,11,1,1,1,1,1,1,1,1,1,1,1,1,9,1,1,1,1,1,1,1,1,1,8,8,8,8,8,1,1,1,1,1,1,9,1,1,1,1,9,9,9,9,9,9,9,9,9,9,9,9,9,9,9,9,9,9,9,9,10,10,10,1,10,10,10,1,1,1,3,
3,1,1,1,1,1,1,1,1,9,1,9,9,9,9,10,10,1,10,10,9,9,9,9,9,9,9,9,5,9,9,9,9,9,9,1,1,1,1,1,1,1,1,9,1,1,1,1,1,1,1,1,1,8,8,8,8,8,1,1,1,1,1,1,9,1,1,1,1,9,1,1,1,9,9,9,9,1,1,1,1,1,1,1,1,1,1,1,1,10,10,10,1,10,10,10,1,1,1,3,
3,1,1,1,1,1,1,1,1,9,1,1,1,1,1,1,10,1,10,1,1,1,1,1,1,1,1,1,1,1,1,1,1,1,9,9,9,9,9,9,9,9,9,9,1,1,1,1,1,1,1,1,1,8,8,8,8,8,1,10,10,10,1,1,9,1,1,1,10,10,10,1,1,9,9,9,9,1,1,8,8,8,8,8,8,1,1,1,1,10,10,10,1,10,10,10,1,1,1,3,
3,1,1,1,1,1,1,1,1,9,9,9,9,9,9,10,10,1,10,10,9,9,9,9,9,9,9,9,9,9,9,9,9,1,9,1,1,1,1,1,1,10,10,10,10,10,1,1,1,1,1,1,1,8,8,8,8,8,1,10,10,10,9,9,9,9,9,9,10,10,10,9,9,9,9,9,9,1,1,8,8,8,8,8,8,1,1,1,1,10,10,10,1,10,10,10,1,1,1,3,
3,1,1,1,1,1,1,1,1,1,1,1,1,1,1,10,10,1,10,10,1,1,1,1,11,1,1,1,1,1,1,1,9,1,9,9,9,9,9,9,9,10,10,10,10,10,9,9,9,9,9,9,1,8,8,8,8,8,1,10,10,10,1,1,9,9,9,1,10,10,10,1,1,1,9,9,9,1,1,8,8,8,8,8,8,12,9,9,1,10,10,10,1,10,10,10,1,1,1,3,
3,1,1,1,1,1,1,1,1,1,1,1,1,1,1,1,9,1,9,1,1,1,8,8,8,8,8,8,1,1,1,1,9,1,1,1,1,1,1,1,1,1,1,10,10,10,1,1,1,1,1,9,1,8,8,8,8,8,1,1,9,1,1,1,9,9,9,1,1,9,1,1,1,10,10,10,10,10,1,8,8,8,8,8,8,1,1,9,1,1,1,9,1,9,1,1,1,1,1,3,
3,1,1,1,9,9,9,9,9,9,9,9,9,9,9,9,9,1,9,1,1,1,8,8,8,8,8,8,1,1,1,1,9,9,9,9,9,9,9,9,9,10,1,1,1,10,9,9,9,9,1,9,1,8,8,8,8,8,1,1,9,1,1,1,9,9,9,1,1,9,1,1,1,10,10,10,10,10,1,8,8,8,8,8,8,1,1,9,1,1,1,9,1,9,1,1,1,1,1,3,
3,1,1,1,9,1,1,1,1,1,1,1,1,1,1,1,5,1,9,1,1,1,8,8,8,8,8,8,1,1,1,1,1,1,1,1,11,1,1,1,1,10,10,10,10,10,1,1,1,5,1,9,1,1,1,1,11,1,1,1,9,1,1,1,9,9,9,1,1,9,9,9,9,10,10,10,10,10,1,8,8,8,8,8,8,1,1,9,1,1,1,9,1,9,1,1,1,1,1,3,
3,1,1,1,9,1,1,1,1,1,1,1,1,1,1,1,9,1,9,1,1,1,8,8,8,8,8,8,1,1,1,1,1,8,8,8,8,8,8,1,1,1,1,11,1,1,1,1,1,9,1,9,9,9,9,9,9,9,9,9,9,9,9,9,9,9,9,1,1,9,1,1,9,10,10,10,10,10,1,1,1,11,1,1,1,1,1,9,1,1,1,9,1,9,1,1,1,1,1,3,
3,1,1,1,9,1,1,1,1,1,1,1,1,1,1,1,9,1,9,1,1,1,8,8,8,8,8,8,1,1,1,1,1,8,8,8,8,8,8,1,1,8,8,8,8,8,8,1,1,9,1,9,1,1,1,1,1,1,1,1,9,1,9,1,9,9,9,1,1,9,1,1,9,10,10,10,10,10,1,10,10,10,10,10,1,1,1,9,1,1,1,9,1,9,1,1,1,1,1,3,
3,1,1,1,9,1,1,1,1,1,1,1,1,1,1,1,9,1,9,1,1,1,8,8,8,8,8,8,1,1,1,1,1,8,8,8,8,8,8,1,1,8,8,8,8,8,8,1,1,9,1,9,9,9,9,9,9,5,9,9,9,9,9,9,9,9,9,1,1,9,1,1,9,1,1,1,1,1,1,10,1,10,10,10,9,9,9,9,9,9,9,9,1,9,1,1,1,1,1,3,
3,1,1,1,9,1,1,1,1,1,1,1,1,1,1,1,9,1,9,1,1,1,1,1,1,1,1,1,1,1,1,1,1,8,8,8,8,8,8,1,1,8,8,8,8,8,8,1,1,9,1,9,1,1,1,1,1,1,1,1,1,1,1,1,1,1,9,9,9,9,9,9,9,9,9,9,9,9,9,10,5,5,5,5,5,1,1,1,1,1,1,1,1,9,1,1,1,1,1,3,
3,1,1,1,9,9,9,9,9,9,9,9,9,9,9,9,9,1,9,1,1,1,1,1,1,1,1,1,1,1,1,1,1,8,8,8,8,8,8,1,1,8,8,8,8,8,8,12,9,9,1,9,9,9,9,9,9,9,9,9,9,9,9,9,9,9,9,1,1,1,1,1,9,1,1,1,1,1,1,10,1,10,10,10,9,9,9,9,9,9,9,9,9,9,1,1,1,1,1,3,
3,1,1,1,1,1,1,1,1,1,1,1,1,1,1,1,9,9,9,9,9,9,9,9,9,1,1,1,1,1,1,1,1,8,8,8,8,8,8,1,1,8,8,8,8,8,8,1,1,9,1,9,1,1,1,1,1,1,1,1,1,1,1,1,1,1,1,1,1,1,1,1,9,1,1,1,1,1,1,10,1,1,1,10,1,1,1,1,1,1,1,1,1,1,1,1,1,1,1,3,
3,1,1,1,1,1,1,1,1,1,1,1,1,1,1,1,1,1,1,1,1,1,1,1,1,1,1,1,1,1,1,1,1,1,1,1,1,1,1,1,1,8,8,8,8,8,8,1,1,9,1,9,1,1,1,1,1,1,1,1,1,1,1,1,1,1,1,1,1,1,1,1,9,9,9,9,9,9,9,9,9,9,9,9,1,1,1,1,1,1,1,1,1,1,1,1,1,1,1,3,
3,1,1,1,1,1,1,1,1,1,1,1,1,1,1,1,1,1,1,1,1,1,1,1,1,1,1,1,1,1,1,1,1,1,1,1,1,1,1,1,1,1,1,1,1,1,1,1,1,9,9,9,1,1,1,1,1,1,1,1,1,1,1,1,1,1,1,1,1,1,1,1,1,1,1,1,1,1,1,1,1,1,1,1,1,1,1,1,1,1,1,1,1,1,1,1,1,1,1,3,
3,1,1,1,1,1,1,1,1,1,1,1,1,1,1,1,1,1,1,1,1,1,1,1,1,1,1,1,1,1,1,1,1,1,1,1,1,1,1,1,1,1,1,1,1,1,1,1,1,2,2,2,1,1,1,1,1,1,1,1,1,1,1,1,1,1,1,1,1,1,1,1,1,1,1,1,1,1,1,1,1,1,1,1,1,1,1,1,1,1,1,1,1,1,1,1,1,1,1,3,
3,1,1,1,1,1,1,1,1,1,1,1,1,1,1,1,1,1,1,1,1,1,1,1,1,1,1,1,1,1,1,1,1,1,1,1,1,1,1,1,1,1,1,1,1,1,1,1,1,2,2,2,1,1,1,1,1,1,1,1,1,1,1,1,1,1,1,1,1,1,1,1,1,1,1,1,1,1,1,1,1,1,1,1,1,1,1,1,1,1,1,1,1,1,1,1,1,1,1,3,
3,3,3,3,3,3,3,3,3,3,3,3,3,3,3,3,3,3,3,3,3,3,3,3,3,3,3,3,3,3,3,3,3,3,3,3,3,3,3,3,3,3,3,3,3,3,3,3,3,2,2,2,3,3,3,3,3,3,3,3,3,3,3,3,3,3,3,3,3,3,3,3,3,3,3,3,3,3,3,3,3,3,3,3,3,3,3,3,3,3,3,3,3,3,3,3,3,3,3,3,
